{
  "levels": [
    {
      "name": "Garden",
      "tile_size": 16,
      "palette": {
        "1": 97,
        "2": 98,
        "3": 99,
        "4": 129,
        "5": 161,
        ".": 130
      },
      "tiles": [
        "11111111111111111111111111111111",
        "1..............................1",
        "1....2222..............444.....1",
        "1....2..2......................1",
        "1....2..2.......55555..........1",
        "1....2222.......5...5..........1",
        "1................5.5...........1",
        "1.........333....5.5...........1",
        "1.........333....555...........1",
        "1..............................1",
        "1..............222222..........1",
        "1..............2....2..........1",
        "1..............222222.....4....1",
        "1..............................1",
        "1.....5555.....................1",
        "1.....5..5.........3333........1",
        "1.....5555.........3333........1",
        "1..............................1",
        "1..............................1",
        "11111111111111111111111111111111"
      ]
    }
  ]
}
